#Core Classes
Fighter	IPFGSDTALCOREPLAYER
Priest	IPFGSDTALCOREPLAYER
Thief	IPFGSDTALCOREPLAYER
Wizard	IPFGSDTALCOREPLAYER
#Cursed Scroll 1 Classes
Knight of St. Ydris	IPFGSDTALCS1PLAYER
Warlock	IPFGSDTALCS1PLAYER
Witch	IPFGSDTALCS1PLAYER
#Cursed Scroll 2 Classes
Desert Rider	IPFGSDTALCS2PLAYER
Pit Fighter	IPFGSDTALCS2PLAYER
Ras-Godai	IPFGSDTALCS2PLAYER
#Cursed Scroll 3 Classes
Sea Wolf	IPFGSDTALCS3PLAYER
Seer	IPFGSDTALCS3PLAYER
#Unnatural Selection Classes
Beastmaster	IPFGSDDDCUNSPLAYER
Fiend	IPFGSDDDCUNSPLAYER
Grave Warden	IPFGSDDDCUNSPLAYER
Ovate	IPFGSDDDCUNSPLAYER
Plague Doctor	IPFGSDDDCUNSPLAYER
Shaman	IPFGSDDDCUNSPLAYER
#Core Ancestries
Dwarf	IPFGSDTALCOREPLAYER
Elf	IPFGSDTALCOREPLAYER
Goblin	IPFGSDTALCOREPLAYER
Half-Orc	IPFGSDTALCOREPLAYER
Halfling	IPFGSDTALCOREPLAYER
Human	IPFGSDTALCOREPLAYER
#Unnatural Selection Ancestries
Chelonian	IPFGSDDDCUNSPLAYER
Dragonborn	IPFGSDDDCUNSPLAYER
Forest Elf	IPFGSDDDCUNSPLAYER
Half Troll	IPFGSDDDCUNSPLAYER
Shadow Elf	IPFGSDDDCUNSPLAYER
Tiefling	IPFGSDDDCUNSPLAYER
Gnome	IPFGSDDDCUNSPLAYER
Mycellan	IPFGSDDDCUNSPLAYER
Risen	IPFGSDDDCUNSPLAYER
Slimefolk	IPFGSDDDCUNSPLAYER
Skurrid	IPFGSDDDCUNSPLAYER
Sylvaren	IPFGSDDDCUNSPLAYER
#Core Backgrounds
Urchin	IPFGSDTALCOREPLAYER
Wanted	IPFGSDTALCOREPLAYER
Cult Initiate	IPFGSDTALCOREPLAYER
Thieves Guild	IPFGSDTALCOREPLAYER
Banished	IPFGSDTALCOREPLAYER
Orphaned	IPFGSDTALCOREPLAYER
Wizard's Apprentice	IPFGSDTALCOREPLAYER
Wizard’s Apprentice	IPFGSDTALCOREPLAYER
Jeweler	IPFGSDTALCOREPLAYER
Herbalist	IPFGSDTALCOREPLAYER
Barbarian	IPFGSDTALCOREPLAYER
Mercenary	IPFGSDTALCOREPLAYER
Sailor	IPFGSDTALCOREPLAYER
Acolyte	IPFGSDTALCOREPLAYER
Soldier	IPFGSDTALCOREPLAYER
Ranger	IPFGSDTALCOREPLAYER
Scout	IPFGSDTALCOREPLAYER
Minstrel	IPFGSDTALCOREPLAYER
Scholar	IPFGSDTALCOREPLAYER
Noble	IPFGSDTALCOREPLAYER
Chirurgeon	IPFGSDTALCOREPLAYER
#Cursed Scroll 1 Backgrounds
Hermit	IPFGSDTALCS1PLAYER
Outcast	IPFGSDTALCS1PLAYER
Woodborn	IPFGSDTALCS1PLAYER
Amnesiac	IPFGSDTALCS1PLAYER
Haunted	IPFGSDTALCS1PLAYER
Fugitive	IPFGSDTALCS1PLAYER
Feytouched	IPFGSDTALCS1PLAYER
Witchborn	IPFGSDTALCS1PLAYER
Forager	IPFGSDTALCS1PLAYER
Redeemer	IPFGSDTALCS1PLAYER
Marked	IPFGSDTALCS1PLAYER
Sacrifice	IPFGSDTALCS1PLAYER
Marooned	IPFGSDTALCS1PLAYER
Fallen	IPFGSDTALCS1PLAYER
Drawn	IPFGSDTALCS1PLAYER
Ascetic	IPFGSDTALCS1PLAYER
Wolfchild	IPFGSDTALCS1PLAYER
Healer	IPFGSDTALCS1PLAYER
Chosen	IPFGSDTALCS1PLAYER
Demonborn	IPFGSDTALCS1PLAYER
#Cursed Scroll 3 Backgrounds
Freed	IPFGSDTALCS3PLAYER
Displaced	IPFGSDTALCS3PLAYER
Criminal	IPFGSDTALCS3PLAYER
Drifter	IPFGSDTALCS3PLAYER
Crop Farmer	IPFGSDTALCS3PLAYER
Livestock Farmer	IPFGSDTALCS3PLAYER
Hunter	IPFGSDTALCS3PLAYER
Fisher	IPFGSDTALCS3PLAYER
Enforcer	IPFGSDTALCS3PLAYER
Trader	IPFGSDTALCS3PLAYER
Crafter	IPFGSDTALCS3PLAYER
Bowyer	IPFGSDTALCS3PLAYER
Seer's Apprentice	IPFGSDTALCS3PLAYER
Seer’s Apprentice	IPFGSDTALCS3PLAYER
Shipwright	IPFGSDTALCS3PLAYER
Blacksmith	IPFGSDTALCS3PLAYER
Far Traveler	IPFGSDTALCS3PLAYER
Skald	IPFGSDTALCS3PLAYER
Heroborn	IPFGSDTALCS3PLAYER
Nobleborn	IPFGSDTALCS3PLAYER
God's Blood	IPFGSDTALCS3PLAYER
God’s Blood	IPFGSDTALCS3PLAYER
#Unnatural Selection Backgrounds
Lupine	IPFGSDDDCUNSPLAYER
Aerian	IPFGSDDDCUNSPLAYER
Ursine	IPFGSDDDCUNSPLAYER
Feral	IPFGSDDDCUNSPLAYER
Treant	IPFGSDDDCUNSPLAYER
Rescued	IPFGSDDDCUNSPLAYER
Exiled	IPFGSDDDCUNSPLAYER
Hunter	IPFGSDDDCUNSPLAYER
Fisher	IPFGSDDDCUNSPLAYER
Cannibalborn	IPFGSDDDCUNSPLAYER
Beastmaster Apprentice	IPFGSDDDCUNSPLAYER
Shamanic	IPFGSDDDCUNSPLAYER
Barbarian	IPFGSDDDCUNSPLAYER
Snake Charmer	IPFGSDDDCUNSPLAYER
Ovate	IPFGSDDDCUNSPLAYER
Astronomer	IPFGSDDDCUNSPLAYER
Skyseer	IPFGSDDDCUNSPLAYER
Chiefling	IPFGSDDDCUNSPLAYER
Spirit Spawn	IPFGSDDDCUNSPLAYER
Pariah	IPFGSDDDCUNSPLAYER
Executioner	IPFGSDDDCUNSPLAYER
Treasonous	IPFGSDDDCUNSPLAYER
Deathwise	IPFGSDDDCUNSPLAYER
Scrapper	IPFGSDDDCUNSPLAYER
Wanted	IPFGSDDDCUNSPLAYER
Cult Initiate	IPFGSDDDCUNSPLAYER
Insider	IPFGSDDDCUNSPLAYER
Grave Warden Apprentice	IPFGSDDDCUNSPLAYER
Plague Doctor Apprentice	IPFGSDDDCUNSPLAYER
Bone Setter	IPFGSDDDCUNSPLAYER
Abused	IPFGSDDDCUNSPLAYER
Undertaker's Kin	IPFGSDDDCUNSPLAYER
Undertaker’s Kin	IPFGSDDDCUNSPLAYER
Orphaned	IPFGSDDDCUNSPLAYER
Former Slaver	IPFGSDDDCUNSPLAYER
Avenger	IPFGSDDDCUNSPLAYER
Liberator	IPFGSDDDCUNSPLAYER
Grave Digger	IPFGSDDDCUNSPLAYER
Gambler	IPFGSDDDCUNSPLAYER
Phylactery	IPFGSDDDCUNSPLAYER
